0A010000 1A010000 1A010000 1A010000 1A010000 1A010000 1A010000 1A010000 1A010000 1A010000 1A010000 1A010000 1A010000 1A010000 1A010000 1A010000 
1A010000 0A000000 0A000000 0A000000 0A000000 0A000000 0A000000 0A000000 0A000312 0A000000 0A000000 0A000000 0A000000 0A000000 0A000000 0A000000 
1A010000 0A000000 0A000000 0A000000 0A000000 0A000000 0A000000 0A000000 0A000312 0A000000 0A000000 0A000000 0A000000 0A000000 0A000000 2A0002C0 
1A010000 0A000000 0A000000 0A000000 0A000000 0A000000 0A000000 0A000000 0A000312 2A0002C0 2A0002B0 2A0002F0 0A000000 0A000000 2A0002C0 2A0002B0 
1A010000 0A000000 0A000000 0A000000 0A000000 0A000000 0A000000 0A000000 0A000312 1A0002B0 1A0002B0 1A0002E0 0A000000 2A0002C0 2A0002B0 2A0002B0 
1A010000 0A000000 0A000000 0A000000 0A000000 0A000000 0A000000 0A000000 0A000312 1A1302A0 1A130000 1A1302D0 0A000000 1A0E02B0 1A0E02B0 1A0E02B0 
1A010000 0A000000 0A000000 0A000000 0A000000 0A000000 0A000000 0A000000 0A000312 1A130000 1A130080 1A130000 0A000000 1A0E02B0 0A0E02B0 0A1302A0 
1A010000 0A000000 0A000000 0A000000 0A000000 0A000000 0A000000 0A000000 0A000312 1A130000 3A290070 1A130000 0A000000 1A1302B0 0A1302A0 1A0A0270 